
F 255, 0,255
WE                wall_textures/wall_west.png    



NO wall_textures/wall_north.png
C 0, 0, 255

SO wall_textures/wall_south.png
EA wall_textures/wall_east.png







        111111111111111111111111111
        1000000000110000000000001
        1011000001110000000000001
        1001000000000000000000001
111111111011000001110000000000001
1000000000110000011101111111111111
11110111111111011100000010001
11110111111111111111111111111
11110111111111011101010010001
11000000110101011100010000001
100000000000000000000000100011
10000000000000001E0001010010001
110000011101010110110111100111
11110111 1110101 101111010001
11111111 1111111 11111111101    
        111111111111111111011111111
        1000000000110000000000001
        1011000001110000000000001
        1001000000000000000000001
111111111010000001110000000000001
1000000000110000011101111111111111
11110111111111011100000010001
11110111111111111111111111111
11110111111111011101010010001
110000001101010111000100000011
1000000000000000000000100100011
1000000000000000110001010010001
110000011101010110110111100111
11110111 1110101 101111010001
11111111 1111111 11111111111    